*******************************
課題1 : 佐野和輝 163334
ファイル名：news4.txt
英語ニュースからの単語切り出し
*******************************
  単語：a	出現回数：10
  単語：about	出現回数：4
  単語：accelerate	出現回数：1
  単語：acquisitions	出現回数：2
  単語：acre	出現回数：1
  単語：across	出現回数：1
  単語：acuras	出現回数：1
  単語：adler	出現回数：1
  単語：alexandria	出現回数：1
  単語：already	出現回数：2
  単語：also	出現回数：1
  単語：am	出現回数：1
  単語：americas	出現回数：1
  単語：and	出現回数：11
  単語：are	出現回数：2
  単語：as	出現回数：2
  単語：assist	出現回数：1
  単語：at	出現回数：2
  単語：auto	出現回数：1
  単語：automaker	出現回数：1
  単語：automation	出現回数：1
  単語：autonomous	出現回数：7
  単語：autonomy	出現回数：1
  単語：be	出現回数：1
  単語：been	出現回数：3
  単語：behind	出現回数：1
  単語：being	出現回数：1
  単語：besides	出現回数：1
  単語：big	出現回数：1
  単語：billion	出現回数：2
  単語：bought	出現回数：1
  単語：building	出現回数：1
  単語：but	出現回数：1
  単語：by	出現回数：5
  単語：calif	出現回数：1
  単語：california	出現回数：1
  単語：car	出現回数：1
  単語：carmakers	出現回数：1
  単語：cars	出現回数：4
  単語：cede	出現回数：1
  単語：centered	出現回数：1
  単語：chief	出現回数：1
  単語：civic	出現回数：1
  単語：co	出現回数：1
  単語：collision	出現回数：1
  単語：committed	出現回数：2
  単語：companies	出現回数：1
  単語：company	出現回数：1
  単語：concept	出現回数：1
  単語：concord	出現回数：1
  単語：costs	出現回数：1
  単語：cruise	出現回数：1
  単語：current	出現回数：1
  単語：deliver	出現回数：1
  単語：democratize	出現回数：1
  単語：departure	出現回数：1
  単語：develop	出現回数：1
  単語：development	出現回数：2
  単語：differentiator	出現回数：1
  単語：differs	出現回数：1
  単語：driverless	出現回数：1
  単語：driving	出現回数：6
  単語：easy	出現回数：1
  単語：editing	出現回数：1
  単語：edt	出現回数：1
  単語：efforts	出現回数：1
  単語：engineer	出現回数：1
  単語：everyone	出現回数：1
  単語：facility	出現回数：1
  単語：features	出現回数：2
  単語：five	出現回数：1
  単語：for	出現回数：8
  単語：former	出現回数：1
  単語：forward	出現回数：1
  単語：francisco	出現回数：1
  単語：french	出現回数：1
  単語：from	出現回数：1
  単語：full	出現回数：1
  単語：functionality	出現回数：1
  単語：functions	出現回数：2
  単語：gave	出現回数：1
  単語：general	出現回数：2
  単語：gomentum	出現回数：1
  単語：has	出現回数：5
  単語：have	出現回数：2
  単語：high	出現回数：1
  単語：highways	出現回数：1
  単語：honda	出現回数：9
  単語：hopes	出現回数：1
  単語：hype	出現回数：1
  単語：ideal	出現回数：1
  単語：in	出現回数：7
  単語：including	出現回数：1
  単語：industry	出現回数：2
  単語：infrastructure	出現回数：1
  単語：investments	出現回数：1
  単語：is	出現回数：2
  単語：it	出現回数：6
  単語：its	出現回数：3
  単語：january	出現回数：1
  単語：japanese	出現回数：1
  単語：jim	出現回数：1
  単語：jun	出現回数：1
  単語：just	出現回数：1
  単語：keeping	出現回数：1
  単語：keller	出現回数：2
  単語：lane	出現回数：2
  単語：larger	出現回数：1
  単語：leslie	出現回数：1
  単語：less	出現回数：1
  単語：like	出現回数：1
  単語：lineup	出現回数：1
  単語：lot	出現回数：2
  単語：lure	出現回数：1
  単語：luxury	出現回数：1
  単語：major	出現回数：1
  単語：maker	出現回数：1
  単語：marked	出現回数：1
  単語：market	出現回数：1
  単語：mass	出現回数：1
  単語：mile	出現回数：1
  単語：miles	出現回数：2
  単語：mode	出現回数：1
  単語：model	出現回数：1
  単語：models	出現回数：1
  単語：months	出現回数：2
  単語：motor	出現回数：1
  単語：motors	出現回数：2
  単語：munitions	出現回数：1
  単語：naval	出現回数：1
  単語：new	出現回数：1
  単語：niche	出現回数：1
  単語：northeast	出現回数：1
  単語：of	出現回数：9
  単語：off	出現回数：3
  単語：offering	出現回数：1
  単語：on	出現回数：5
  単語：other	出現回数：2
  単語：our	出現回数：1
  単語：out	出現回数：2
  単語：over	出現回数：2
  単語：pave	出現回数：1
  単語：paved	出現回数：1
  単語：pedestrians	出現回数：1
  単語：pervasive	出現回数：1
  単語：plans	出現回数：1
  単語：preview	出現回数：1
  単語：profile	出現回数：1
  単語：projects	出現回数：1
  単語：promise	出現回数：2
  単語：promises	出現回数：1
  単語：prototypes	出現回数：2
  単語：radar	出現回数：1
  単語：recent	出現回数：2
  単語：referring	出現回数：1
  単語：related	出現回数：1
  単語：reported	出現回数：1
  単語：reporters	出現回数：1
  単語：reporting	出現回数：1
  単語：research	出現回数：2
  単語：rivals	出現回数：2
  単語：roadway	出現回数：1
  単語：roll	出現回数：1
  単語：rolled	出現回数：1
  単語：s	出現回数：1
  単語：safety	出現回数：2
  単語：sage	出現回数：1
  単語：said	出現回数：2
  単語：san	出現回数：1
  単語：saw	出現回数：1
  単語：saying	出現回数：1
  単語：says	出現回数：2
  単語：self	出現回数：5
  単語：semi	出現回数：3
  単語：series	出現回数：1
  単語：showed	出現回数：1
  単語：shown	出現回数：1
  単語：shows	出現回数：1
  単語：shuttles	出現回数：1
  単語：site	出現回数：1
  単語：sneak	出現回数：1
  単語：spending	出現回数：1
  単語：start	出現回数：1
  単語：station	出現回数：1
  単語：stop	出現回数：1
  単語：talked	出現回数：1
  単語：technologies	出現回数：1
  単語：technology	出現回数：2
  単語：test	出現回数：1
  単語：testing	出現回数：3
  単語：tests	出現回数：1
  単語：than	出現回数：1
  単語：that	出現回数：1
  単語：the	出現回数：15
  単語：their	出現回数：1
  単語：there	出現回数：3
  単語：these	出現回数：1
  単語：this	出現回数：1
  単語：thu	出現回数：1
  単語：ticket	出現回数：1
  単語：to	出現回数：9
  単語：toyota	出現回数：2
  単語：tunnels	出現回数：1
  単語：turn	出現回数：1
  単語：two	出現回数：1
  単語：under	出現回数：2
  単語：unique	出現回数：1
  単語：unless	出現回数：1
  単語：up	出現回数：1
  単語：used	出現回数：1
  単語：vehicle	出現回数：1
  単語：vocal	出現回数：1
  単語：warning	出現回数：2
  単語：was	出現回数：1
  単語：way	出現回数：3
  単語：we	出現回数：2
  単語：wednesday	出現回数：2
  単語：which	出現回数：3
  単語：while	出現回数：1
  単語：who	出現回数：1
  単語：whose	出現回数：1
  単語：will	出現回数：2
  単語：with	出現回数：1
  単語：year	出現回数：1
  単語：years	出現回数：1
  単語：zone	出現回数：1
　単語総数　全部で226 種類の単語が現れました。
